11111111
10011001
11013100
10111111
11111111
11110111
11211111
11111111
