11000001111111111000111111111101
10000000111111111001111111111100
00000000111111111011111111111100
00000000001111110010111111111100
00000000000111111011111113111100
10000000001111111111111111111101
10000000001111111111111111111101
10000000100111111111111111111111
10000000110111111111111111111111
00000000111100111100011111111111
10000000111101111000001111111111
11000000111111111000011111111111
11100000111111111000111111111111
11000000111111111000111111111111
11000000111111111000000000011111
11000000011111110000000000011111
11111100001111110000000000001111
11111000001111110000000000001111
11111000001111110000000000001111
11010000011111111000000000001111
11000000111111111110000000000001
10000000011111111111111110000000
10000000111111111111111111100000
00000000111111111111111110100000
00000000011211111111111111000000
00001100001111111111111110000000
00001110001111111111111100000000
00011110011111001111111000000000
00111111111011001111110000000000
00111111111001000011100000000000
11111111111100000000000000000000
11111111111110000000001100000000
