11111100
00131110
01111111
10111111
11111000
10011111
11112111
10011001
