11111111111111111111111000111111
11111111101111111111111001111111
11111111011111111111110001111111
11111110000011111011110111111111
11111110000001111110111111111111
00000000000111111111011111111111
00000000000111111111111100011111
00000000011111131111111110110010
00000000011111111111111111000000
10000000011111111111111111110000
11100000011111111111111111111000
11000000011111111111111011111111
11000000001111111111110011111111
11000000000001111110000001111111
10000000000001111110000001111111
10000000000001111100000000111111
00000000001111111100000000011111
00000000011111111100000000001111
00000000011111111111111100000111
00000000011111111111111100000111
00000000011111111111111000000111
10000000001111111111111000000011
11000000011111111111111000000001
11000000001111111111111110000000
11000000000001111111111111010000
11000000000001111111111111111000
10000000011011111111111111110000
10000000111111111111111111111000
00000000111111211111111111111011
00000001111111111111111111111001
11100000111111111111111011111111
11110000111111111111111111111111
