11110111
13101111
11111111
11101111
11111111
10011111
11011210
11011110
