11000011111111011111111111111111
11111111111111110011101111111111
11111111111111111111111111111111
11110010011111011001000111311111
11111000001100000000001111111111
10011000000000000000011111111111
10011100000000000000111111111111
00011100000000000000111111111111
00001111000000000000111111111111
00001111100000000000111111111111
10001111111000000000011111111111
11111111111110000000111111110001
11111111111111000000011111110000
11111111111111100000011111111000
11111111111111110000011111010000
11111111111111110000011111010000
11111211111111110000000111111110
11111111111111110000000011111111
11111111111111111000001111111111
11111111101111111111111111111111
11111111000111111111111111111111
11110111001111111111111111111111
11111111001111111111111111111111
11100000001111111111111011111111
11100000001111111111100001111111
11100001111111111111100001111111
11110001111111111111000000010111
01110011101101011111000000000001
00011111101000001111000000000000
00011111100000001111111000000000
00011111110011101111111100000001
11100111111111111111111100000001
