10111110
10001301
11101101
11111111
11111111
11201101
01111111
11111111
