11111111
01113111
10111110
11111011
11100011
01111111
11112111
11111111
