11111111101111000001111111111111
11111111100110000011111111111111
11110111000000000011111111111000
11111111100000000011111111111000
11111111111101000001111111111000
11111111111111111111111111111000
11111111111111111111311111111000
11111111111111111111111111111000
11111111111111111111111111111111
11111111111111111111111111111111
11111111111111111111111001111111
11111111111111111111111001111111
11111111111000110111111100111111
11111111111000000011111100011111
11111111111100000011111000111111
11111111111100000111110111111111
11111111111100001111111111111111
11111111111000111111111111111111
11111111111110111111111111111111
11111111111111111111111111111111
11111111111111111111111111110011
11112111111111111111111111000001
11111111111100111111110110000000
11111111111111111111100000000000
11111111111111111111000000000000
01111001111111100100000000000000
01111101111111100000000000000000
11111111111110000100000000000000
11111111111110001000000011100000
11011111111111000000110111110000
11000111111111100000111111110000
11000011111111100000011111111110
