11111111101111111011111111111111
11111111111111111111111111111111
11111111111111111111111111111111
11111111110011111011111111111111
11111111110011111011111131111111
11111111111111110001111111111111
11111100111110000000011111111111
11110000111110000000000111111111
11100000111111000000001111111111
00000000111111000000001111111111
10000001111111000000001111111111
10000011111111100000011111111111
10000011111111100000111111111111
11001011111111101001111111111111
11111111111111000111111111111111
11111110111110000111111111111111
11111100111110001111111111111111
11110000011100011111111011111111
11110000001111111111111111111111
11110000000111111111111111111111
11100000001111111111111111111111
11111000001111111111111111111111
11111111111111111111111101111111
01111111111111111101111100111111
11111111111111111110001100011110
11111112111111111111111110001100
11111111111111111111111111111100
11111111111111111111111111111110
11111111111111111111111111111111
11111111111111111100011111111111
11100001111111111100011111110111
11000000111111111100011111110111
