11100111
01111311
00111111
10001111
11000111
11111111
01211111
11111011
