11111111
11111311
10000111
10111111
11111111
11111111
11012101
00011111
